# #####################################################
#         #                               # #     # # #
# ### # ##### ### ### ### ####### ######### # ##### # #
#   # #     #   # # #   #       #       #       #   # #
# ##### # ### ##### ##### # ############### ####### # #
#     # #       # # #   # #   # #         #     # #   #
# # ##### ### ### # # ######### # ######### ##### ### #
# #   #     #               #       #               # #
# # # # # # # ####### ####### ####### ##### # ### ### #
# # # # # # #       #       #           # # #   #     #
# ##### # # # # # ########### ####### ### ##### # ### #
#   # # # # # # #               #   # #     # # #   # #
# ### ### ### ### # ####### ##### ##### ##### ### #####
#       # #     # #       #   #   # # #   #     #     #
# # # # ##### ##### # ##### ### ### # # ### ##### #####
# # # #   #     # # #     # #           #       # # # #
# # ### ##### ### ### ####### ### # # ### ######### # #
# #   #   #   #         #       # # #             #   #
# # # # ### # ### # # ### ####### ### ######### ### ###
# # # #   # # #   # #   #   #   # #           # #     #
# # # # ######### ### ### ### ####### # # ######### ###
# # # # #   #     #               #   # #       # #   #
# # ##### ### # # # # # # ### ####### ### # # ### # ###
# #         # # # # # # #   #       #   # # #         #
# # # # # ### # # # ### # ####### # # ### ### ####### #
# # # # #   # # # # #   #       # # #   #   #       # #
### ##### ########### # # ####### ### ####### # #######
#       #     # #     # #       # #         # #       #
# # # ### ##### ### # # # # # ### ### # ####### #######
# # #   #         # # # # # # #     # #     #         #
# ### ### # # # # # ### # ####### # # # # # ### # ### #
# #     # # # # # #   # #       # # # # # #   # #   # #
# ### # # ######### ### # # ####### # # ### ##### ### #
#   # # #       # # # # # #       # # #   #   #     # #
# ### ### # ##### ### ##### ### ### # # ##### # # ### #
# #     # #             #     #   # # #     # # # #   #
# # # ### # # # # # # # # # # # ### ### # ######### # #
# # # #   # # # # # # # # # # #   #   # #         # # #
# ### ### ##### ### ##### ######### # ### # # # ##### #
# #   #     # # #     #           # #   # # # #     # #
##### ### ### ##### ### # # ######### ######### # # # #
#     #         #     # # #       #           # # # # #
# # # ### ######### # ### # ####### # # # ####### # # #
# # # #       # # # #   # #       # # # #   #   # # # #
# ####### # ### # ### ############# ######### ##### ###
#     #   #         #         #   #               #   #
# # # # # # # # # ### # # # ### ########### ####### ###
# # # # # # # # #   # # # #       # #   # #       #   #
# # # ### # ### # ##### ### ### ### # ### ### #########
# # #   # # #   #     # #     #   #         # # #   # #
##### ##### ### # # ####### ### ### ##### ##### # ### #
#         # #   # #       # #     #     #   #         #
##### ### ##### ############# # ### ######### ##### # #
#       # #               #   #                   # # #
##################################################### #
